NO ./textures/wall.png
SO ./textures/wall.png
WE ./textures/wall.png
EA ./textures/wall.png
F 150,100,50
C 200,150,255

11111111111111111
10000000001000001
10000000001000001
10000W00001000001
10000000001000001
11111111111111111
