NO ./textures/wall.png
SO ./textures/wall.png
WE ./textures/wall.png
EA ./textures/wall.png
F 100,100,100
C 200,200,200

      111111
      100001
11111110N001
100000000001
111111111111
