NO ./textures/wall.png
SO ./textures/wall.png
WE ./textures/wall.png
EA ./textures/wall.png
F 75,75,75
C 128,128,200

1111111111111111111
1000000000000000001
1000000000000000001
1000000000000000001
1000000000000000001
1000000E00000000001
1000000000000000001
1000000000000000001
1000000000000000001
1111111111111111111
