NO ./textures/wall.png
SO ./textures/wall.png
WE ./textures/wall.png
EA ./textures/wall.png
F 50,50,50
C 255,255,255

11111111111
10000000001
10000S00001
10000000001
11111111111
