NO ./textures/north.png
SO ./textures/south.png
WE ./textures/west.png
EA ./textures/east.png
F 100,100,110
C 60,90,150

111111111111111111111111
100000000000000000000001
101111011111011111011101
101000010000010000010001
101011110111110111110101
101010000100000100000101
101010111101110101110101
101010100001010101000101
101010101111010101011101
101000101000010001000001
101110101011111101111101
100010001010000001000001
101011111010111101011101
101000000010100001010001
101111111110101111010101
100000000000101000010001
101111111110101011111101
100000000010001010000001
101111111011111010111101
100000001000000010000001
101111101011111111011101
100000001010000000010001
1000000000N0000000000001
111111111111111111111111
