111111111111111111111
1E0000000000000C000C1
101001010010000010101
101001001010101000101
1P0000000C00C00000001
111111111111111111111