NO ./textures/wall.png
SO ./textures/wall.png
WE ./textures/wall.png
F 100,100,100
C 200,200,200

111111
100N01
111111

