NO ./textures/wall.png
SO ./textures/wall.png
WE ./textures/wall.png
EA ./textures/wall.png
F 100,100,100
C 200,200,200

111111
1N0N01
111111
