11111111111
1EP1CCCCCC1
1001CCCCCC1
1000CCCCCC1
11111111111