1111111111111
100100E0000C1
1000000011001
1P00110000001
1111111111111
