111111111111111
100C00E00C000P1
111111111111111